{

	"width": 16, "height": 16,

	"data": [

		0,0,0,0,0,0,0,0,0,0,0,0,0,0,0,0,
		0,4,4,4,4,4,4,5,5,5,5,4,4,4,4,0,
		0,4,4,4,4,4,4,5,5,5,5,4,4,4,4,0,
		0,4,4,4,4,4,5,5,5,5,5,4,4,4,4,0,
		0,4,4,4,4,5,5,5,5,5,5,5,4,4,4,0,
		0,4,4,4,5,5,3,3,3,3,5,5,5,5,4,0,
		0,5,5,5,5,3,8,3,3,3,3,5,5,5,5,0,
		0,5,5,5,5,3,3,3,3,3,3,5,5,5,5,0,
		0,5,5,5,5,3,3,3,3,3,3,5,5,5,5,0,
		0,5,4,5,5,3,3,3,3,7,3,5,5,5,5,0,
		0,5,5,5,5,5,3,3,3,3,5,5,5,5,5,0,
		0,4,4,4,5,5,5,5,5,5,5,5,5,5,5,0,
		0,4,4,4,4,5,4,5,5,5,5,5,5,5,5,0,
		0,4,4,4,4,4,5,5,5,5,5,5,5,4,5,0,
		0,4,4,4,4,4,5,5,5,5,5,5,5,5,5,0,
		0,0,0,0,0,0,0,0,0,0,0,0,0,0,0,0

	],

	"ref": [

		"Brrr... It's pretty cold here!\nYou should wear some warmer cloths\nreally...",
		{ "map": "main.json", "x": 11, "y": -11 }

	]

}
