{

	"width": 16, "height": 16,

	"data": [

		0,0,0,0,0,0,0,0,0,0,0,0,0,0,0,0,
		0,6,6,6,6,6,6,6,6,6,6,6,6,6,6,0,
		0,6,6,6,6,6,6,6,6,6,6,6,6,6,6,0,
		0,6,6,6,6,6,6,6,6,6,6,6,6,6,6,0,
		0,6,6,6,6,6,6,6,6,6,6,6,6,6,6,0,
		0,6,6,6,6,6,3,3,3,3,6,6,6,6,6,0,
		0,6,6,6,6,3,8,3,3,3,3,6,6,6,6,0,
		0,6,6,6,6,3,3,3,3,3,3,6,6,6,6,0,
		0,6,6,6,6,3,3,3,3,3,3,6,6,6,6,0,
		0,6,6,6,6,3,3,3,3,7,3,6,6,6,6,0,
		0,6,6,6,6,6,3,3,3,3,6,6,6,6,6,0,
		0,6,6,6,6,6,6,6,6,6,6,6,6,6,6,0,
		0,6,6,6,6,6,6,6,6,6,6,6,6,6,6,0,
		0,6,6,6,6,6,6,6,6,6,6,6,6,6,6,0,
		0,6,6,6,6,6,6,6,6,6,6,6,6,6,6,0,
		0,0,0,0,0,0,0,0,0,0,0,0,0,0,0,0

	],

	"ref": [

		"Careful not to fall in...",
		{ "map": "main.json", "x": -11, "y": 11 }

	]

}
