{

	"width": 32, "height": 32,

	"data": [

		0,0,0,0,0,0,0,0,0,0,0,0,0,0,0,0,0,0,0,0,0,0,0,0,0,0,0,0,0,0,0,0,
		0,1,1,1,1,1,1,1,1,1,1,1,1,1,1,1,1,1,1,1,1,1,1,1,1,1,1,1,1,1,1,0,
		0,1,7,1,1,1,1,1,1,1,1,1,1,1,1,1,1,1,1,1,1,1,1,1,1,1,1,1,1,7,1,0,
		0,1,1,1,1,1,1,1,1,1,1,1,1,1,1,1,1,1,1,1,1,1,1,1,1,1,1,1,1,1,1,0,
		0,1,1,1,1,1,1,1,1,1,1,1,1,1,1,1,1,1,1,1,1,1,1,1,1,1,1,1,1,1,1,0,
		0,1,1,1,1,1,1,1,1,1,1,1,1,1,1,1,1,1,1,1,1,1,1,1,1,1,1,1,1,1,1,0,
		0,1,1,1,1,1,1,1,1,1,1,1,1,1,1,1,1,1,1,1,1,1,1,1,1,1,1,1,1,1,1,0,
		0,1,1,1,1,1,1,1,1,1,1,1,1,1,1,1,1,1,1,1,1,1,1,1,1,1,1,1,1,1,1,0,
		0,1,1,1,1,1,1,1,1,1,1,1,1,1,1,1,1,1,1,1,1,1,1,1,1,1,1,1,1,1,1,0,
		0,1,1,1,1,1,1,1,1,1,1,1,1,1,1,1,1,1,1,1,1,1,1,1,1,1,1,1,1,1,1,0,
		0,1,1,1,1,1,1,1,1,1,1,1,1,1,1,1,1,1,1,1,1,1,1,1,1,1,1,1,1,1,1,0,
		0,1,1,1,1,1,1,1,1,1,1,1,6,6,6,6,6,6,6,6,1,1,1,1,1,1,1,1,1,1,1,0,
		0,1,1,1,1,1,1,1,1,1,1,6,6,5,5,5,5,5,5,6,6,1,1,1,1,1,1,1,1,1,1,0,
		0,1,1,1,1,1,1,1,1,1,1,6,5,8,5,5,5,5,8,5,6,1,1,1,1,1,1,1,1,1,1,0,
		0,1,1,1,1,1,1,1,1,1,1,6,5,5,5,5,5,5,5,5,6,1,1,1,1,1,1,1,1,1,1,0,
		0,1,1,1,1,1,1,1,1,1,1,6,5,5,5,5,5,5,5,5,6,1,1,1,1,1,1,1,1,1,1,0,
		0,1,1,1,1,1,1,1,1,1,1,6,5,5,5,5,5,5,5,5,6,1,1,1,1,1,1,1,1,1,1,0,
		0,1,1,1,1,1,1,1,1,1,1,6,5,5,5,5,5,5,5,5,6,1,1,1,1,1,1,1,1,1,1,0,
		0,1,1,1,1,1,1,1,1,1,1,6,5,8,5,5,5,5,8,5,6,1,1,1,1,1,1,1,1,1,1,0,
		0,1,1,1,1,1,1,1,1,1,1,6,6,5,5,5,5,5,5,6,6,1,1,1,1,1,1,1,1,1,1,0,
		0,1,1,1,1,1,1,1,1,1,1,1,6,6,5,5,5,5,6,6,1,1,1,1,1,1,1,1,1,1,1,0,
		0,1,1,1,1,1,1,1,1,1,1,1,1,1,1,1,1,1,1,1,1,1,1,1,1,1,1,1,1,1,1,0,
		0,1,1,1,1,1,1,1,1,1,1,1,1,1,1,1,1,1,1,1,1,1,1,1,1,1,1,1,1,1,1,0,
		0,1,1,1,1,1,1,1,1,1,1,1,1,1,1,1,1,1,1,1,1,1,1,1,1,1,1,1,1,1,1,0,
		0,1,1,1,1,1,1,1,1,1,1,1,1,1,1,1,1,1,1,1,1,1,1,1,1,1,1,1,1,1,1,0,
		0,1,1,1,1,1,1,1,1,1,1,1,1,1,1,1,1,1,1,1,1,1,1,1,1,1,1,1,1,1,1,0,
		0,1,1,1,1,1,1,1,1,1,1,1,1,1,1,1,1,1,1,1,1,1,1,1,1,1,1,1,1,1,1,0,
		0,1,1,1,1,1,1,1,1,1,1,1,1,1,1,1,1,1,1,1,1,1,1,1,1,1,1,1,1,1,1,0,
		0,1,1,1,1,1,1,1,1,1,1,1,1,1,1,1,1,1,1,1,1,1,1,1,1,1,1,1,1,1,1,0,
		0,1,7,1,1,1,1,1,1,1,1,1,1,1,1,1,1,1,1,1,1,1,1,1,1,1,1,1,1,7,1,0,
		0,1,1,1,1,1,1,1,1,1,1,1,1,1,1,1,1,1,1,1,1,1,1,1,1,1,1,1,1,1,1,0,
		0,0,0,0,0,0,0,0,0,0,0,0,0,0,0,0,0,0,0,0,0,0,0,0,0,0,0,0,0,0,0,0

	],

	"ref": [

		{ "map": "water.json", "x": 0, "y": 0 },
		{ "map": "ice.json", "x": 0, "y": 0 },
		"HINT: Run into signs to see what they say.",
		"WARNING: Beware of lava.",
		"HINT: Somewhere around here is a teleporter.",
		"HINT: The answer is 42.",
		{ "map": "lava.json", "x": 0, "y": 0 },
		{ "map": "speed.json", "x": 0, "y": 0}

	]

}
