{

	"width": 16, "height": 16,

	"data": [

		0,0,0,0,0,0,0,0,0,0,0,0,0,0,0,0,
		0,1,1,1,1,1,1,1,1,1,1,0,1,1,1,0,
		0,1,1,1,1,1,1,8,1,1,1,0,1,7,1,0,
		0,1,1,1,1,1,1,1,1,1,1,0,1,1,1,0,
		0,1,1,1,1,1,1,1,1,1,1,0,1,1,1,0,
		0,1,1,1,1,1,1,1,1,1,1,1,1,1,1,0,
		0,1,1,1,1,1,1,1,1,1,1,1,1,1,1,0,
		0,1,1,1,1,1,1,1,1,1,1,1,1,1,1,0,
		0,0,0,0,0,0,0,1,1,0,0,0,0,0,0,0,
		0,0,0,0,0,0,0,1,1,0,0,0,0,0,0,0,
		0,0,0,0,0,0,0,1,1,0,0,0,0,0,0,0,
		0,1,1,1,1,1,1,1,1,1,1,1,1,1,1,0,
		0,1,8,1,1,8,1,1,1,1,8,1,7,1,1,0,
		0,1,1,1,1,1,1,1,1,1,1,1,1,1,1,0,
		0,1,1,1,1,1,1,1,8,1,1,1,1,1,1,0,
		0,0,0,0,0,0,0,0,0,0,0,0,0,0,0,0

	],

	"ref": [

		"What is this? Another room?",
		{ "map": "ice.json", "x": 0, "y": 0 },
		"I'm a sign.",
		"I'm a sign too.",
		"Me four!!",
		{ "map": "main.json", "x": 11, "y": 11 },
		"Me three!!"

	]

}
