{

	"width": 16, "height": 16,

	"data": [

		0,0,0,0,0,0,0,0,0,0,0,0,0,0,0,0,
		0,4,4,4,4,4,4,4,4,4,4,4,4,4,4,0,
		0,4,4,4,4,4,4,4,4,4,4,4,4,4,4,0,
		0,4,4,4,4,4,4,4,4,4,4,4,4,4,4,0,
		0,4,4,4,4,4,4,4,4,4,4,4,4,4,4,0,
		0,4,4,4,4,4,3,3,3,3,4,4,4,4,4,0,
		0,4,4,4,4,3,8,3,3,3,3,4,4,4,4,0,
		0,4,4,4,4,3,3,3,3,3,3,4,4,4,4,0,
		0,4,4,4,4,3,3,3,3,3,3,4,4,4,4,0,
		0,4,4,4,4,3,3,3,3,7,3,4,4,4,4,0,
		0,4,4,4,4,4,3,3,3,3,4,4,4,4,4,0,
		0,4,4,4,4,4,4,4,4,4,4,4,4,4,4,0,
		0,4,4,4,4,4,4,4,4,4,4,4,4,4,4,0,
		0,4,4,4,4,4,4,4,4,4,4,4,4,4,4,0,
		0,4,4,4,4,4,4,4,4,4,4,4,4,4,4,0,
		0,0,0,0,0,0,0,0,0,0,0,0,0,0,0,0

	],

	"ref": [

		"NOTICE: This island is owned by Ben Stockett. NO TRESPASSING!!!",
		{ "map": "main.json", "x": -11, "y": -11 }

	]

}
